[
	[ 0, 0, 0, 0, 0, 0, 0, 0, 0, 0, 0, 0, 0, 0, 0, 0, 0, 0, 0],
	[ 0, 0, 0, 0, 0, 0, 0, 0, 0, 0, 0, 0, 0, 0, 0, 0, 0, 0, 0],
	[ 0, 0, 0, 0, 0, 0, 0, 0, 0, 0, 0, 0, 0, 0, 0, 0, 0, 0, 0],
	[ 0, 0, 0, 0, 0, 0, 0, 0, 0, 0, 0, 0, 0,18, 0, 0, 0, 0, 0],
	[ 0, 0, 0, 0, 0, 0, 0, 0, 0, 0, 0, 0,62,63,63,64, 0, 0, 0],
	[ 0, 0, 0, 0, 0, 0, 0, 0, 0, 0, 0, 0, 0, 0, 0, 0, 0, 0, 0],
	[ 0, 0, 2, 3, 4, 0, 0, 0, 0, 0, 0, 0, 0, 0, 0, 0, 8, 0, 0],
	[ 0, 0, 0, 0, 0, 0, 0, 0, 0, 0, 0, 0, 0, 0, 0, 0, 0, 0, 0],
	[ 5, 3, 3, 3, 3, 3, 3, 3, 3, 3, 3, 3, 3, 3, 3, 3, 3, 3,35], 
	[ 0, 0, 0, 0, 0, 0, 0, 0, 0, 0, 0, 0, 0, 0, 0, 0, 0, 0, 0],
	[ 0, 0, 0, 0, 0, 0, 0, 0, 0, 0, 0, 0, 0, 0, 0, 0, 0, 0, 0],
	[11,11,11,11,11,11,11,11,11,11,11,11,11,11,11,11,11,11,11],
	[40,40,40,40,40,40,40,40,40,40,40,40,40,40,40,40,40,40,40],
	[40,40,40,40,40,40,40,40,40,40,40,40,40,40,40,40,40,40,40]
]
